maze width,maze height
3,5
mazes
1,4,6,2,5,5,8,4,8,9,0,1,3,8,5
4,4,6,0,7,1,3,6,2,3,7,4,2,8,4
6,2,1,3,6,3,6,9,0,6,3,1,3,5,7
2,5,8,0,7,5,3,2,6,6,2,7,7,8,9
5,9,0,3,5,7,7,8,4,8,3,6,2,7,5
